2222222222222222222222222222222222222222
2222200000002222222000000000000000000002
2222000000000222222000000000000000000002
2220000000000022222000000000000000000002
2200000020000002222000000000000000000002
2000000221000000222111000000011100000002
2000002220200000022111100000111100001002
2000022220010000002111110001111100000002
2000222220002000000222000000022200000002
2002222220000100000220000000002200000002
2000222220000000000200000200000200000012
2000022220000000200200010201000200000002
2000002220000001000200000200000200000002
2200000220000000000200222222200200000002
2220000020000000000200000200000200001002
2222000020200000000200000200000200000002
2222200020010000000200000200000200000002
2222220020000000000200000200000200000002
2222200020000000000200100200100200100002
2222000020000002000200000200000200000002
2220000220000010000200000000000200000002
2200002020000000000220000000002200000002
2000020020000000000222000000022200001002
2000000020020000000222220002222200000002
2000000020001000000000000000000000000002
2020000020000000000000000000000000000002
2200000220000000000000000000000000000112
2000000020000002000200000000000000000002
2000000020000102000201000000000000000002
2000200020000002000200000000000000000002
2002000020000000010000000100000000001102
2000000220000000000000000000000000000002
2000002020000000000000000000000000000002
2000000020000000000000000000000000000002
2000000020000000000000000000000000011002
2000200020000000000000000000000000000002
2002000020000000000000000000002000000002
20200000200S0000000000000000002000000002
200000G020111020111020110201102011000002
2222222222222222222222222222222222222222