2222222222222222222222222222222222222222
2999066600000JJJJJJ22JJJJJJJJ22J2TTTTTT2
29G900S000000JJJJJJJJJJJJJJJJJJJ2TTTTTT2
2999000000000JJJJJJJJJJJJJJJJJJJ2TTTTTT2
2000099900100J22JJJJJJJJ22JJJJJJ2TTTTTT2
222222222222222222222222222222JJ2TTTTTT2
20000200000000960000JJJJJJJJJ2JJ2TTTTTT2
20000208000000960000JJJJJJJJ0000222TT222
20000200000000960000JJJJJJJ000002TTTTTT2
24400200000000960000JJJJJJ0000002TTTTTT2
20000200000000960000JJJJJ00000002222TT22
20000201000000960770JJJJ200000002TTTTTT2
200332222000002222222222222222032TTTTTT2
2000020020900002222222222222220022222TT2
200002002222000222222222222222402TTTTTT2
233002000222200222222222222222202TTTTTT2
200002000022200200000000000000202222TT22
200002200002000200000000000000202TTTTTT2
200442220000000200000000000000202TTTTTT2
20000220000000220000020000000020222TT222
200002000000002200000900200000202TTTTTT2
200000000200002200000900900200002TTTTTT2
2000000022205022002999999999993322TT2222
200000022222222200205VVVVVVVV0002TTTTTT2
200000222222222200222222222222222TTTTTT2
205502200000000200222200022222222TT22222
222222000000000200222200022222222TTTTTT2
2000000004441002002JJJJJ000000002TTTTTT2
2000000032000002002JJJJJ1777770022TT2222
2000000320000002002JJJJJ222222002TTTTTT2
2000003200000022002JJ222200000002TTTTTT2
2002222000040222002JJJJJ20066666222TT222
2000020000002222002JJJJJ200222222TTTTTT2
2000020000022222002JJJJJ2772TT002TTRRTT2
2000020000222222002222JJ2002TT0022222222
2220023000000000009JJJJJ2662TT0000R00222
2000020000000000009JJJJJ200TTT0000000222
2000020000000000009JJJJJ200TTT2000000222
20RR020077006600339JJJJJ200TTT2207770222
2222222222222222222222222222222222222222